11111111111111111111111111111111
1000000000C01000000000C0000001E1
10000000001110001000000000001101
10000000001100011100000000011101
100000000000000P1100000000000001
11111111111111111111111111111111
