111111111111111111111111
111000000000000C00011111
101001010011111000011111
1010010010C0000000111111
111000000000000C00011111
1P0000000C00C00000011111
111111111000000000111111
100000000000000C00011111
100000011111111111111111
110000000000000C00E11111
111111111111111111111111
