11111111111111
10000000000001
10100101001111
1C10010010C001
11100000000001
1P0000000C00C1
11111111100001
10000000000001
10000001111111
11000000000001
11111111111111
