11111111111111
10000000E00001
10100101001111
1C10010010C001
11100000000001
1P0000000C00C1
11111111111111
