1111111111
10000000P1
100E0000C1
1111111111
