11111111111111111111111111111111111111111111111
100000000000000C0000000000000000000000000000001
10100101001000001010010000101000000000000000001
10100100101010100010010000000111111111111111111
1E0000000000000C00000C0000000000000000000000001
1P0000000C00C0000000000000000000C00000000000001
11111111111111111111111111111111111111111111111
100000000000000C00000C0000000000000000000000001
11111111111111111111111111111111111111111111111
100000000000000C00000C0000000000000000000000001
11100000000000000000000000000000000000000011111
100000000000000C0000000000000000000000000000001
11111111111111111111111111111111111111111111111
1000000000C000000000000000000000000000000000001
11111111111111111111111111111111111111111111111
1000000000C000C00000000000000000000000000000001
11111111111111111111111111111111111111111111111
10000000000000C00000000000000000000000000000001
11111111111111111111111111111111111111111111111
1000000000000CC00000000000000000000000000000001
11111111111111111111111111111111111111111111111
1000000000000C00000C000000000000000000000000001
11111111111111111111111111111111111111111111111
10000000000000C00000C00000000000000000000000001
11111111111111111111111111111111111111111111111
1000000000000C00000C000000000000000000000000001
11111111111111111111111111111111111111111111111
1000000000000C00000C000000000000000000000000001
11111111111111111111111111111111111111111111111
1000000000000C00000C000000000000000000000000001
11111111111111111111111111111111111111111100001
1000000000000C00000C000000000000000000000000001
11111111111111111111111111111111111111111111111
