1111111111111111
10000000000000C1
1000000001111101
10E0000000000001
1000000000000001
1000000000000001
1P00000000100001
100C1C0000100001
1001000000100001
1001000000100001
10010000001000C1
1001000000111101
1001000000000001
1001110111000001
10000000C0000001
1111111111111111


