1111111111111111
10000000000000C1
1E00000001111101
1110000000100001
10010000001000C1
1001000000111101
1001110111000001
10000000C00000P1
1111111111111111
