1111111111111111
100000000000X0C1
1000000001111101
10E000000000X001
1000000000000001
1000000000000001
1P000000XC100001
10C1C00000100001
1001000000100001
1001000X00100001
10010000001000C1
1001000000111101
1001000000000001
10011101110X0001
10000000C0000001
1111111111111111