11111111111111111111111111
1000C01000000000C0000001E1
1P001110001000000000001101
10001100011100000000011101
10000000001100000000000001
11111111111111111111111111
