111111111111
1000000000P1
001E01010011
111111111111
