111111111111
1E0000000001
101001010011
101001001001
1P0000000CC1
111111111111
