111111111111
1E0000000001
001E01010011
101001001001
1P0000000001
111111111111
