111111111111
1C000000C001
101E01010011
101001001001
1P000CC0C001
111111111111
