1111111111
1000000001
1000000001
1000000001
1000000001
1000000001
10C0000001
1000000001
1000000001
1000000001
1000111101
1000000001
1000100001
1000000001
1000000P01
1000000001
100E000001
1000000001
1000000001
1111111111
